0 41 0 0 0 0 0 0 0 0 0 0 0 0 0 0 0 0 
0 0 0 0 0 0 0 0 0 0 0 0 0 0 0 0 0 0 
0 0 0 0 0 0 0 0 0 0 0 0 0 0 0 0 0 0 
0 41 0 0 42 43 42 43 42 43 42 43 42 43 42 43 0 0 
0 41 0 0 16 16 16 16 16 88 89 90 16 88 89 90 0 0 
0 0 0 0 16 16 56 57 57 57 91 16 56 57 91 16 0 0 
0 0 0 0 16 16 63 64 64 64 92 16 63 64 92 16 0 0 
0 41 0 0 16 16 63 64 64 64 92 16 63 64 92 16 0 0 
0 41 0 0 16 16 63 64 64 64 92 16 63 64 24 25 0 0 
0 0 0 0 16 16 63 64 64 64 92 16 63 64 32 33 0 0 
0 0 0 0 16 120 121 122 64 85 92 16 42 43 0 0 0 0 
0 41 0 0 16 125 16 126 64 87 93 16 0 0 0 0 0 0 
0 41 0 0 42 43 42 43 42 43 42 43 0 0 0 0 0 0 
0 0 0 0 0 0 0 0 0 0 0 0 0 0 0 0 0 0 
0 0 0 0 0 0 0 0 0 0 0 0 0 0 0 0 0 0 
0 41 0 0 0 0 0 0 0 0 0 0 0 0 0 0 0 0 
