41 0 0 41 41 0 0 41 41 0 0 41 41 0 0 41 41 0 0 41 41 0 0 41 41 0 0 41 41 0 0 41 
0 0 0 0 0 0 0 0 0 0 0 0 0 0 0 0 0 0 0 0 0 0 0 0 0 0 0 0 0 0 0 0 
0 0 4 5 5 5 5 5 5 5 5 48 49 5 5 48 49 5 5 5 5 5 5 48 49 5 5 5 5 5 0 0 
41 0 13 9 9 9 9 9 9 9 9 54 55 9 9 54 55 9 9 9 9 9 9 54 55 9 9 9 9 9 0 41 
41 0 13 9 9 9 9 9 9 9 9 54 55 9 9 54 55 9 9 9 9 9 9 54 55 9 9 9 9 9 0 41 
0 0 13 9 9 9 9 9 9 9 70 71 72 73 70 71 72 73 9 9 9 9 70 71 72 73 9 9 9 9 0 0 
0 0 13 9 9 9 9 9 9 9 0 0 0 0 0 17 17 0 0 17 17 0 0 0 0 0 18 9 9 9 0 0 
41 0 13 9 9 9 9 9 0 0 0 41 41 0 0 0 0 0 0 0 0 0 0 41 41 0 0 0 9 9 0 41 
41 0 26 27 9 9 9 9 10 5 0 41 41 0 0 41 41 0 0 41 41 0 0 41 41 0 4 5 9 9 0 41 
0 0 34 35 9 9 9 9 9 9 0 0 0 0 0 0 0 0 0 0 0 0 0 0 0 0 13 9 9 9 0 0 
0 0 0 0 0 0 18 9 9 9 5 48 49 5 5 5 5 5 5 48 49 5 0 0 0 0 13 9 9 9 0 0 
41 0 0 41 41 0 0 0 9 9 9 54 55 9 9 9 9 9 9 54 55 9 0 41 41 0 13 9 0 0 0 41 
41 0 0 41 41 0 4 5 9 9 9 54 55 9 9 9 9 9 9 54 55 9 0 41 41 0 13 9 10 5 0 41 
0 0 0 0 0 0 13 9 9 9 70 71 72 73 9 9 9 9 70 71 72 73 0 0 0 0 13 9 9 9 0 0 
0 0 0 0 0 0 0 0 0 0 0 0 0 0 0 0 0 0 0 0 0 0 0 0 0 0 18 9 9 9 0 0 
41 0 0 41 41 0 0 41 41 0 0 41 41 0 0 41 41 0 0 41 41 0 0 41 41 0 0 0 9 9 0 41 
41 0 0 41 41 0 0 41 41 0 0 41 41 0 0 41 41 0 0 41 41 0 0 41 41 0 4 5 9 9 0 41 
0 0 0 0 0 0 0 0 0 0 0 0 0 0 0 0 0 0 0 0 0 0 0 0 0 0 13 9 9 9 0 0 
0 0 4 5 5 5 5 5 5 5 0 0 0 0 4 5 5 5 5 48 49 5 5 5 5 5 6 9 9 9 0 0 
41 0 13 9 9 9 9 9 9 9 0 41 41 0 13 9 9 9 9 54 55 9 9 9 9 9 9 9 0 0 0 41 
41 0 13 9 9 9 9 9 9 9 0 41 41 0 13 9 9 9 9 54 55 9 9 9 9 9 9 9 10 5 0 41 
0 0 13 9 9 9 9 9 9 9 0 0 0 0 13 9 9 9 70 71 72 73 9 9 9 9 9 9 9 9 0 0 
0 0 13 9 9 9 9 9 9 9 0 0 0 0 18 9 9 9 0 0 0 0 0 17 17 0 18 9 9 9 0 0 
41 0 13 9 9 9 9 9 0 0 0 41 41 0 0 0 9 9 0 41 41 0 0 0 0 0 0 0 9 9 0 41 
41 0 26 27 9 9 9 9 10 5 0 41 41 0 4 5 9 9 0 41 41 0 0 41 41 0 4 5 9 9 0 41 
0 0 34 35 9 9 9 9 9 9 0 0 0 0 13 9 9 9 0 0 0 0 0 0 0 0 13 9 9 9 0 0 
0 0 0 0 0 0 18 9 9 9 5 48 49 5 6 9 9 9 0 0 0 0 5 48 49 5 6 9 9 9 0 0 
41 0 0 41 41 0 0 0 9 9 9 54 55 9 9 9 0 0 0 41 41 0 9 54 55 9 9 9 0 0 0 41 
41 0 0 41 41 0 4 5 9 9 9 54 55 9 9 9 10 5 0 41 41 0 9 54 55 9 9 9 10 5 0 41 
0 0 0 0 0 0 13 9 9 9 70 71 72 73 9 9 9 9 0 0 0 0 70 71 72 73 9 9 9 9 0 0 
0 0 0 0 0 0 0 17 17 0 0 0 0 0 0 17 17 0 0 0 0 0 0 0 0 0 0 0 0 0 0 0 
41 0 0 41 41 0 0 0 0 0 0 41 41 0 0 0 0 0 0 41 41 0 0 41 41 0 0 41 41 0 0 41 
41 0 0 41 41 0 0 41 41 0 0 41 41 0 0 41 41 0 0 41 41 0 0 41 41 0 0 41 41 0 0 41 
0 0 0 0 0 0 0 0 0 0 0 0 0 0 0 0 0 0 0 0 0 0 0 0 0 0 0 0 0 0 0 0 
