0 0 0 0 0 0 0 0 0 0 0 0 0 0 0 0 0 0 0 0 0 0 0 0 0 0 0 0 0 0 0 0 
0 0 0 0 0 0 0 0 0 0 0 0 0 0 0 0 0 0 0 0 0 0 0 0 0 0 0 0 0 0 0 0 
2 3 2 3 2 3 2 3 2 3 2 3 2 3 2 3 2 3 2 3 2 3 2 3 2 3 2 3 2 3 2 3 
3 12 12 2 3 12 12 19 19 12 12 19 19 12 12 19 19 12 12 2 3 12 12 2 3 12 12 2 3 12 12 2 
2 3 4 5 20 5 5 5 20 5 5 5 20 5 5 5 20 5 5 5 20 5 5 5 20 5 5 5 20 5 2 3 
3 12 13 9 21 9 9 9 21 9 9 9 21 9 9 9 21 9 9 9 21 9 9 9 21 9 9 9 21 9 12 2 
2 3 13 9 21 9 2 3 2 3 2 3 2 3 2 3 2 3 2 3 2 3 18 9 21 9 2 3 2 3 2 3 
3 12 13 9 21 9 12 2 3 12 12 2 3 12 12 2 3 12 12 2 3 12 13 9 21 9 12 2 3 12 12 2 
2 3 13 9 21 9 10 5 20 5 5 5 20 5 5 5 12 12 4 5 20 5 6 9 21 9 10 5 24 25 2 3 
3 12 13 9 31 9 9 9 21 9 9 9 21 9 9 9 12 12 13 9 21 9 9 9 31 9 9 9 32 33 12 2 
2 3 2 3 2 3 2 3 2 3 18 9 21 9 9 9 12 12 13 9 21 9 2 3 2 3 2 3 2 3 2 3 
3 12 12 2 3 12 12 2 3 12 13 9 21 9 9 9 12 12 13 9 21 9 12 2 3 12 12 2 3 12 12 2 
2 3 4 5 20 5 5 5 20 5 6 9 21 9 9 9 12 12 13 9 21 9 10 5 20 5 5 5 20 5 2 3 
3 12 13 9 21 9 9 9 21 9 9 9 31 9 9 9 39 39 13 9 31 9 9 9 21 9 9 9 21 9 12 2 
2 3 13 9 21 9 2 3 2 3 2 3 2 3 2 3 2 3 2 3 2 3 2 3 2 3 2 3 2 3 2 3 
3 12 13 9 21 9 12 19 19 12 12 19 19 12 12 19 19 12 12 19 19 12 12 2 3 12 12 2 3 12 12 2 
2 3 13 9 21 9 5 5 20 5 5 5 20 5 5 5 20 5 5 5 20 5 5 5 20 5 5 5 20 5 2 3 
3 12 13 9 31 9 9 9 21 9 9 9 21 9 9 9 21 9 9 9 21 9 9 9 21 9 9 9 21 9 12 2 
2 3 2 3 2 3 2 3 2 3 2 3 2 3 2 3 2 3 2 3 2 3 18 9 21 9 9 9 21 9 2 3 
3 12 12 2 3 12 12 2 3 12 12 2 3 12 12 2 3 12 12 2 3 12 13 9 21 9 9 9 21 9 12 2 
2 3 4 5 20 5 5 5 20 5 5 5 20 5 5 5 20 5 5 5 20 5 6 9 21 9 9 9 21 9 2 3 
3 12 13 9 21 9 9 9 21 9 9 9 21 9 9 9 21 9 9 9 21 9 9 9 31 9 9 9 21 9 12 2 
2 3 13 9 21 9 9 9 21 9 9 9 21 9 9 9 21 9 9 9 21 9 2 3 2 3 18 9 21 9 2 3 
3 12 13 9 21 9 9 9 21 9 9 9 21 9 9 9 21 9 9 9 21 9 12 2 3 12 13 9 21 9 12 2 
2 3 13 9 21 9 9 9 21 9 9 9 21 9 9 9 21 9 9 9 21 9 10 5 20 5 6 9 21 9 2 3 
3 12 13 9 21 9 9 9 31 9 9 9 31 9 9 9 31 9 9 9 31 9 9 9 21 9 9 9 21 9 12 2 
2 3 13 9 21 9 2 3 2 3 2 3 2 3 2 3 2 3 2 3 2 3 18 9 21 9 9 9 21 9 2 3 
3 12 13 9 21 9 12 2 3 12 12 2 3 12 12 2 3 12 12 2 3 12 13 9 21 9 9 9 21 9 12 2 
2 3 13 9 21 9 10 5 20 5 5 5 20 5 5 5 20 5 5 5 20 5 6 9 21 9 9 9 21 9 2 3 
3 12 13 9 31 9 9 9 21 9 9 9 21 9 9 9 21 9 9 9 21 9 9 9 21 9 9 9 21 9 12 2 
2 3 2 3 2 3 18 9 21 9 9 9 21 9 9 9 21 9 9 9 21 9 9 9 21 9 9 9 21 9 2 3 
3 12 12 2 3 12 13 9 21 9 9 9 21 9 9 9 21 9 9 9 21 9 9 9 21 9 9 9 21 9 12 2 
2 3 4 5 20 5 6 9 21 9 9 9 21 9 9 9 21 9 9 9 21 9 9 9 21 9 9 9 21 9 2 3 
3 12 13 9 21 9 9 9 31 9 9 9 31 9 9 9 21 9 9 9 31 9 9 9 31 9 9 9 21 9 12 2 
2 3 2 3 2 3 2 3 2 3 2 3 2 3 18 9 21 9 2 3 2 3 2 3 2 3 18 9 21 9 2 3 
3 12 12 2 3 12 12 2 3 12 12 2 3 12 13 9 21 9 12 2 3 12 12 2 3 12 13 9 21 9 12 2 
2 3 4 5 20 5 5 5 20 5 5 5 20 5 6 9 21 9 10 5 20 5 5 5 20 5 6 9 21 9 2 3 
3 12 13 9 21 9 9 9 21 9 9 9 21 9 9 9 21 9 9 9 21 9 9 9 21 9 9 9 31 9 12 2 
2 3 13 9 21 9 9 9 21 9 9 9 21 9 9 9 21 9 9 9 21 9 9 9 21 9 2 3 2 3 2 3 
3 12 13 9 21 9 9 9 21 9 9 9 21 9 9 9 21 9 9 9 21 9 9 9 21 9 12 2 3 12 12 2 
2 3 13 9 21 9 9 9 21 9 9 9 21 9 9 9 21 9 9 9 21 9 9 9 21 9 10 5 20 5 2 3 
3 12 13 9 21 9 9 9 31 9 9 9 31 9 9 9 31 9 9 9 31 9 9 9 31 9 9 9 21 9 12 2 
2 3 13 9 21 9 2 3 2 3 2 3 2 3 2 3 2 3 2 3 2 3 2 3 2 3 18 9 21 9 2 3 
3 12 13 9 21 9 12 2 3 12 12 2 3 12 12 2 3 12 12 2 3 12 12 2 3 12 13 9 21 9 12 2 
2 3 13 9 21 9 10 5 20 5 5 5 20 5 5 5 12 12 4 5 20 5 5 5 20 5 6 9 21 9 2 3 
3 12 13 9 31 9 9 9 21 9 9 9 21 9 9 9 12 12 13 9 21 9 9 9 21 9 9 9 31 9 12 2 
2 3 2 3 2 3 18 9 21 9 9 9 21 9 9 9 12 12 13 9 21 9 9 9 21 9 2 3 2 3 2 3 
3 12 12 2 3 12 13 9 21 9 9 9 21 9 9 9 12 12 13 9 21 9 9 9 21 9 12 2 3 12 12 2 
2 3 4 5 20 5 6 9 21 9 9 9 21 9 9 9 12 12 13 9 21 9 9 9 21 9 10 5 20 5 2 3 
3 12 13 9 21 9 9 9 31 9 9 9 21 9 9 9 39 39 13 9 31 9 9 9 31 9 9 9 21 9 12 2 
2 3 13 9 21 9 2 3 2 3 18 9 21 9 2 3 2 3 2 3 2 3 2 3 2 3 18 9 21 9 2 3 
3 12 13 9 21 9 12 2 3 12 13 9 21 9 12 2 3 12 12 2 3 12 12 2 3 12 13 9 21 9 12 2 
2 3 13 9 21 9 10 5 20 5 6 9 21 9 10 5 20 5 5 5 12 12 4 5 20 5 6 9 21 9 2 3 
3 12 13 9 31 9 9 9 21 9 9 9 31 9 9 9 21 9 9 9 12 12 13 9 21 9 9 9 31 9 12 2 
2 3 2 3 2 3 2 3 2 3 2 3 2 3 18 9 21 9 9 9 12 12 13 9 21 9 2 3 2 3 2 3 
3 12 12 2 3 12 12 2 3 12 12 2 3 12 13 9 21 9 9 9 12 12 13 9 21 9 12 2 3 12 12 2 
2 3 4 5 20 5 5 5 20 5 5 5 20 5 6 9 21 9 9 9 12 12 13 9 21 9 10 5 20 5 2 3 
3 12 13 9 21 9 9 9 21 9 9 9 21 9 9 9 31 9 9 9 39 39 13 9 31 9 9 9 21 9 12 2 
2 3 13 9 21 9 9 9 21 9 2 3 2 3 2 3 2 3 2 3 2 3 2 3 2 3 18 9 21 9 2 3 
3 12 13 9 21 9 9 9 21 9 12 2 3 12 12 2 3 12 12 2 3 12 12 2 3 12 13 9 21 9 12 2 
2 3 13 9 21 9 9 9 21 9 10 5 20 5 5 5 12 12 4 5 20 5 5 5 20 5 6 9 21 9 2 3 
3 12 13 9 31 9 9 9 31 9 9 9 21 9 9 9 12 12 13 9 21 9 9 9 21 9 9 9 31 9 12 2 
2 3 2 3 2 3 2 3 2 3 18 9 21 9 9 9 12 12 13 9 21 9 9 9 21 9 2 3 2 3 2 3 
3 12 12 2 3 12 12 19 19 12 13 9 21 9 9 9 12 12 13 9 21 9 9 9 21 9 12 2 3 12 12 2 
2 3 4 5 20 5 5 5 20 5 6 9 21 9 9 9 12 12 13 9 21 9 9 9 21 9 10 5 20 5 2 3 
3 12 13 9 21 9 9 9 21 9 9 9 31 9 9 9 39 39 13 9 31 9 9 9 31 9 9 9 21 9 12 2 
2 3 13 9 21 9 2 3 2 3 2 3 2 3 2 3 2 3 2 3 2 3 2 3 2 3 18 9 21 9 2 3 
3 12 13 9 21 9 12 2 3 12 12 2 3 12 12 2 3 12 12 2 3 12 12 2 3 12 13 9 21 9 12 2 
2 3 13 9 21 9 10 5 20 5 5 5 20 5 5 5 20 5 5 5 12 12 4 5 20 5 6 9 21 9 2 3 
3 12 13 9 31 9 9 9 21 9 9 9 21 9 9 9 21 9 9 9 12 12 13 9 21 9 9 9 31 9 12 2 
2 3 2 3 2 3 18 9 21 9 9 9 21 9 9 9 21 9 9 9 12 12 13 9 21 9 2 3 2 3 2 3 
3 12 12 2 3 12 13 9 21 9 9 9 21 9 9 9 21 9 9 9 12 12 13 9 21 9 12 2 3 12 12 2 
2 3 26 27 4 5 6 9 21 9 9 9 21 9 9 9 21 9 9 9 12 12 13 9 21 9 10 5 24 25 2 3 
3 12 34 35 13 9 9 9 31 9 9 9 21 9 9 9 31 9 9 9 39 39 13 9 31 9 9 9 32 33 12 2 
2 3 2 3 2 3 2 3 2 3 18 9 21 9 2 3 2 3 2 3 2 3 2 3 2 3 2 3 2 3 2 3 
3 12 12 2 3 12 12 2 3 12 13 9 21 9 12 2 3 12 12 2 3 12 12 2 3 12 12 2 3 12 12 2 
2 3 4 5 20 5 5 5 20 5 6 9 21 9 10 5 20 5 5 5 20 5 5 5 20 5 5 5 20 5 2 3 
3 12 13 9 21 9 9 9 21 9 9 9 31 9 9 9 21 9 9 9 21 9 9 9 21 9 9 9 21 9 12 2 
2 3 2 3 2 3 2 3 2 3 2 3 2 3 2 3 2 3 2 3 2 3 2 3 2 3 2 3 2 3 2 3 
3 12 12 2 3 12 12 2 3 12 12 2 3 12 12 2 3 12 12 2 3 12 12 2 3 12 12 2 3 12 12 2 
