0 1 0 1 0 1 0 1 0 1 0 1 0 1 0 1 0 1 
5 6 5 6 5 6 5 6 5 6 5 6 5 6 5 6 5 6 
0 1 0 1 0 1 0 1 0 1 0 1 0 1 0 1 0 1 
5 6 5 6 5 6 5 6 5 6 5 6 5 6 5 6 5 6 
0 1 3 3 3 3 3 3 3 3 3 3 3 4 0 1 0 1 
5 6 4 7 7 3 4 7 7 3 3 3 3 8 5 6 5 6 
0 1 11 12 12 10 11 12 12 10 9 10 9 13 0 1 0 1 
5 6 15 12 12 9 15 12 12 9 10 9 10 16 5 6 5 6 
0 1 11 24 24 10 11 24 24 10 9 10 9 13 0 1 0 1 
5 6 15 33 33 9 15 33 33 9 10 9 10 16 5 6 5 6 
0 1 9 10 9 10 9 10 9 10 9 10 9 13 0 1 0 1 
5 6 10 9 10 9 10 9 10 9 10 9 10 16 5 6 5 6 
0 1 9 10 9 10 9 10 9 10 9 10 9 13 0 1 0 1 
5 6 10 9 10 9 10 9 10 9 10 9 10 16 5 6 5 6 
0 1 27 28 28 28 28 28 28 29 9 10 9 13 0 1 0 1 
5 6 27 28 28 28 28 28 28 29 10 9 10 16 5 6 5 6 
0 1 39 40 40 40 40 40 40 42 9 10 9 13 0 1 0 1 
5 6 10 9 10 9 10 9 10 9 10 9 10 16 5 6 5 6 
0 1 9 10 9 10 9 10 9 10 9 10 9 13 0 1 0 1 
5 6 10 9 10 9 10 9 10 9 10 9 10 16 5 6 5 6 
0 1 9 10 9 10 9 10 9 10 9 10 9 13 0 1 0 1 
5 6 10 9 10 9 10 9 10 9 10 9 10 16 5 6 5 6 
0 1 9 10 9 10 27 28 28 28 28 28 28 57 0 1 0 1 
5 6 10 9 10 11 27 28 28 28 28 28 28 57 5 6 5 6 
0 1 9 10 9 15 39 40 40 40 40 40 40 41 0 1 0 1 
5 6 10 9 10 9 10 9 10 9 10 9 10 16 5 6 5 6 
0 1 9 10 9 10 21 22 23 10 9 10 9 13 0 1 0 1 
5 6 10 9 10 9 30 31 32 9 10 9 10 16 5 6 5 6 
0 1 9 10 9 10 36 37 38 10 9 10 9 13 0 1 0 1 
5 6 10 9 10 9 10 9 10 9 10 9 10 16 5 6 5 6 
0 1 9 10 9 10 9 10 9 10 9 10 9 13 0 1 0 1 
5 6 10 9 10 9 10 9 10 9 10 9 10 16 5 6 5 6 
0 1 0 1 0 1 0 1 0 1 0 1 0 1 0 1 0 1 
5 6 5 6 5 6 5 6 5 6 5 6 5 6 5 6 5 6 
