0 0 0 0 0 0 0 0 0 0 0 0 0 0 0 0 0 0 0 0 0 0 0 0 0 0 0 0 0 0 0 0 0 0 0 0 0 0 0 0 0 0 0 0 0 0 0 0 0 0 0 0 0 0 0 0 0 0 0 0 0 0 0 0 
94 94 94 94 94 94 94 94 94 94 94 94 94 94 94 94 94 94 94 94 94 94 94 94 94 94 94 94 94 94 94 94 94 94 94 94 94 94 94 94 94 94 94 94 94 94 94 94 94 94 94 94 94 94 94 94 94 94 94 94 94 94 94 94 
95 96 97 98 99 100 97 98 99 100 97 98 99 100 97 98 99 100 97 98 99 100 97 98 99 100 97 98 99 100 97 98 99 100 97 98 99 100 97 98 99 100 97 98 99 100 97 98 99 100 97 98 99 100 97 98 99 100 97 95 101 102 103 103 
104 105 106 107 108 109 106 110 111 109 106 107 108 109 106 110 111 109 106 110 111 109 106 107 108 109 106 107 108 109 106 110 111 109 106 107 108 109 106 110 111 109 106 107 108 109 106 107 108 109 106 110 111 109 106 110 111 109 106 104 112 113 114 114 
104 105 106 115 97 116 106 107 108 109 106 115 97 116 106 110 111 109 106 107 108 109 106 115 97 116 106 115 97 116 106 107 108 109 106 115 97 116 106 110 111 109 106 115 97 116 106 115 97 116 106 107 108 109 106 110 111 109 106 104 112 113 114 114 
104 105 106 106 106 106 106 115 97 116 106 106 106 106 106 110 111 109 106 115 97 116 106 106 106 106 106 106 106 106 106 115 97 116 106 106 106 106 106 110 111 109 106 106 106 106 106 106 106 106 106 115 97 116 106 110 111 109 106 104 98 113 114 114 
95 96 106 106 106 106 106 106 106 106 106 106 106 106 106 107 108 109 106 106 106 106 106 106 106 106 106 106 106 106 106 106 106 106 106 106 106 106 106 107 108 109 106 106 106 106 106 106 106 106 106 106 106 106 106 107 108 109 106 104 117 113 114 114 
104 105 106 106 106 106 106 106 106 106 106 106 106 106 106 115 97 116 106 106 106 106 106 106 106 106 106 106 106 106 106 106 106 106 106 106 106 106 106 115 97 116 106 106 106 106 106 106 106 106 106 106 106 106 106 115 97 116 106 104 118 113 114 114 
104 105 120 121 122 123 123 123 123 123 123 123 123 123 123 123 123 123 123 123 123 123 123 123 123 123 123 123 123 123 123 123 123 123 123 123 123 123 123 123 123 123 123 123 123 123 123 123 123 123 123 123 123 123 123 123 123 123 123 104 124 113 114 114 
104 105 125 16 126 16 83 83 83 83 83 83 83 83 83 83 83 83 83 16 16 16 16 16 16 83 83 83 83 83 83 16 16 16 16 16 16 83 83 83 83 83 83 16 16 16 16 16 16 83 83 83 83 83 83 83 83 83 83 127 128 129 130 130 
131 132 133 134 131 132 133 134 131 132 133 134 131 132 133 134 131 132 133 135 16 16 16 16 136 132 133 134 131 132 133 135 16 16 16 16 136 132 133 134 131 132 133 135 16 16 16 16 136 132 133 134 131 132 133 134 131 132 133 134 131 132 133 134 
137 138 139 16 137 138 139 16 137 138 139 16 137 138 139 16 137 138 139 16 16 16 16 16 137 138 139 16 137 138 139 16 16 16 16 16 137 138 139 16 137 138 139 16 16 16 16 16 137 138 139 16 137 138 139 16 137 138 139 16 137 138 139 16 
16 140 16 16 16 140 16 16 16 140 16 16 16 140 16 16 16 140 16 16 16 16 16 16 16 140 16 16 16 140 16 16 16 16 16 16 16 140 16 16 16 140 16 16 16 16 16 16 16 140 16 16 16 140 16 16 16 140 16 16 16 140 16 16 
141 142 141 141 141 142 141 141 141 142 141 141 141 142 141 141 141 142 141 141 141 141 141 141 141 142 141 141 141 142 141 141 141 141 141 141 141 142 141 141 141 142 141 141 141 141 141 141 141 142 141 141 141 142 141 141 141 142 141 141 141 142 141 141 
0 0 0 0 0 0 0 0 0 0 0 0 0 0 0 0 0 0 0 0 0 0 0 0 0 0 0 0 0 0 0 0 0 0 0 0 0 0 0 0 0 0 0 0 0 0 0 0 0 0 0 0 0 0 0 0 0 0 0 0 0 0 0 0 
0 0 0 0 0 0 0 0 0 0 0 0 0 0 0 0 0 0 0 0 0 0 0 0 0 0 0 0 0 0 0 0 0 0 0 0 0 0 0 0 0 0 0 0 0 0 0 0 0 0 0 0 0 0 0 0 0 0 0 0 0 0 0 0 
