0 0 0 0 0 0 0 0 0 0 0 0 0 0 
94 94 94 94 94 94 94 94 94 94 94 94 94 94 
95 96 97 98 99 100 97 98 99 100 97 98 99 100 
104 105 106 107 108 109 106 110 111 109 106 107 108 109 
104 105 106 115 97 116 106 107 108 109 106 115 97 116 
104 105 106 106 106 106 106 115 97 116 106 106 106 106 
95 96 106 106 106 106 106 106 106 106 106 106 106 106 
104 105 106 106 106 106 106 106 106 106 106 106 106 106 
104 105 120 121 122 123 123 123 123 123 123 123 123 123 
104 105 125 16 126 16 83 83 83 83 83 83 83 83 
131 132 133 134 131 132 133 134 131 132 133 134 131 132 
137 138 139 16 137 138 139 16 137 138 139 16 137 138 
16 140 16 16 16 140 16 16 16 140 16 16 16 140 
141 142 141 141 141 142 141 141 141 142 141 141 141 142 
0 0 0 0 0 0 0 0 0 0 0 0 0 0 
0 0 0 0 0 0 0 0 0 0 0 0 0 0 
0 0 0 0 0 0 0 0 0 0 0 0 0 0 
0 0 0 0 0 0 0 0 0 0 0 0 0 0 
2 3 2 3 2 3 2 3 2 3 2 3 2 3 
3 12 12 2 3 12 12 2 3 12 12 2 3 12 
2 3 4 5 5 5 5 5 5 5 5 5 5 5 
3 12 13 9 9 9 9 9 9 9 9 9 9 9 
2 3 2 3 2 3 18 9 9 9 9 9 9 9 
3 12 12 2 3 12 13 9 9 9 9 9 9 9 
2 3 26 27 4 5 6 9 9 9 9 9 9 9 
3 12 34 35 13 9 9 9 9 9 9 9 9 9 
2 3 2 3 2 3 18 9 9 9 9 9 9 9 
3 12 12 2 3 12 13 9 9 9 9 9 9 9 
2 3 4 5 5 5 6 7 8 9 9 9 9 9 
3 12 13 9 9 9 9 14 15 9 9 9 9 9 
2 3 13 9 9 9 12 17 17 12 18 9 9 9 
3 12 13 9 9 9 12 2 3 12 13 9 9 9 
2 3 13 7 8 9 10 5 5 5 6 7 8 9 
3 12 13 14 15 9 9 9 9 9 9 14 15 9 
2 3 2 3 2 3 18 9 9 9 12 17 17 12 
3 12 12 2 3 12 13 9 9 9 12 2 3 12 
2 3 4 5 5 5 6 7 8 9 10 5 5 5 
3 12 13 9 9 9 9 14 15 9 9 9 9 9 
2 3 13 9 9 9 12 17 17 12 18 9 9 9 
3 12 13 9 9 9 12 2 3 12 13 9 9 9 
2 3 13 7 8 9 10 5 5 5 6 7 8 9 
3 12 13 14 15 9 9 9 9 9 9 14 15 9 
2 3 2 3 2 3 18 9 9 9 2 3 2 3 
3 12 12 2 3 12 13 9 9 9 12 2 3 12 
2 3 4 5 5 5 6 7 8 9 10 5 5 5 
3 12 13 9 9 9 9 14 15 9 9 9 9 9 
2 3 13 9 9 9 2 3 2 3 18 9 9 9 
3 12 13 9 9 9 12 2 3 12 13 9 9 9 
2 3 13 7 8 9 10 5 5 5 6 7 8 9 
3 12 13 14 15 9 9 9 9 9 9 14 15 9 
2 3 2 3 2 3 18 9 9 9 12 17 17 12 
3 12 12 2 3 12 13 9 9 9 12 2 3 12 
2 3 4 5 5 5 6 7 8 9 10 5 5 5 
3 12 13 9 9 9 9 14 15 9 9 9 9 9 
2 3 2 3 2 3 2 3 2 3 2 3 2 3 
3 12 12 2 3 12 12 2 3 12 12 2 3 12 
2 3 4 5 5 5 5 5 5 5 5 5 5 5 
3 12 13 9 9 9 9 9 9 9 9 9 9 9 
2 3 13 9 9 9 2 3 2 3 2 3 2 3 
3 12 13 9 9 9 12 2 3 12 12 2 3 12 
2 3 13 7 8 9 10 5 5 5 5 5 5 5 
3 12 13 14 15 9 9 9 9 9 9 9 9 9 
2 3 12 17 17 12 2 3 2 3 18 9 9 9 
3 12 12 2 3 12 12 2 3 12 13 9 9 9 