0 0 0 0 0 0 0 0 0 0 0 0 0 0 0 0 0 0 0 0 0 0 0 0 0 0 0 0 0 0 0 0 
0 0 0 0 0 0 0 0 0 0 0 0 0 0 0 0 0 0 0 0 0 0 0 0 0 0 0 0 0 0 0 0 
0 0 44 45 46 47 44 0 45 46 44 45 46 47 44 45 46 47 44 0 45 46 44 45 46 47 44 0 45 46 0 0 
0 0 51 47 52 52 51 44 45 53 51 47 52 52 51 47 52 52 51 44 45 53 51 47 52 52 51 44 45 53 0 0 
0 0 52 52 52 52 62 47 47 52 52 52 52 52 52 52 52 52 62 47 47 52 52 52 52 52 62 47 47 52 0 0 
0 0 52 69 52 52 62 52 69 52 52 69 52 52 52 69 52 52 62 52 69 52 52 69 52 52 62 52 69 52 0 0 
0 0 69 74 52 52 75 74 76 77 52 74 76 77 69 74 52 52 75 74 76 77 69 74 52 52 75 74 76 77 0 0 
0 0 76 78 77 74 76 79 78 76 76 79 78 76 76 78 77 74 76 79 78 76 76 78 77 74 76 79 78 76 0 0 
0 0 26 27 76 79 78 79 78 79 78 79 78 79 78 78 76 79 78 79 78 79 78 78 76 79 78 79 24 25 0 0 
0 0 34 35 78 78 79 78 79 78 79 78 79 78 78 79 78 78 79 78 79 78 78 79 78 78 79 78 32 33 0 0 
0 0 2 3 2 3 82 82 82 82 2 3 2 3 82 82 82 82 2 3 2 3 82 82 82 82 2 3 2 3 0 0 
0 0 0 0 0 0 83 83 83 83 0 0 0 0 83 83 83 83 0 0 0 0 83 83 83 83 0 0 0 0 0 0 
0 0 0 0 0 0 2 3 2 3 0 0 0 0 2 3 2 3 0 0 0 0 2 3 2 3 0 0 0 0 0 0 
0 0 0 0 0 0 0 0 0 0 0 0 0 0 0 0 0 0 0 0 0 0 0 0 0 0 0 0 0 0 0 0 
0 0 0 0 0 0 0 0 0 0 0 0 0 0 0 0 0 0 0 0 0 0 0 0 0 0 0 0 0 0 0 0 
0 0 0 0 0 0 0 0 0 0 0 0 0 0 0 0 0 0 0 0 0 0 0 0 0 0 0 0 0 0 0 0 
