1 1 1 1 1 1 1 1 1 1 1 1 1 1 1 1 1 1 1 1 1 1 1 1 1 1 1 1 1 1 1 1 
11 11 11 11 11 11 11 11 11 11 11 11 11 11 11 11 11 11 11 11 11 11 11 11 11 11 11 11 11 11 11 11 
0 0 16 16 0 0 16 16 0 0 16 16 0 0 16 16 0 0 16 16 0 0 16 16 0 0 16 16 0 0 16 16 
0 0 0 0 0 0 0 0 0 0 0 0 0 0 0 0 0 0 0 0 0 0 0 0 0 0 0 0 0 0 0 0 
0 0 0 0 0 0 0 0 0 0 0 0 0 0 0 0 0 0 0 0 0 0 0 0 0 0 0 0 0 0 0 0 
0 0 0 4 5 5 0 4 20 5 0 4 20 5 0 4 20 5 0 4 20 5 0 4 20 5 0 4 5 5 0 0 
0 0 0 13 9 9 0 13 21 9 0 13 21 9 0 13 21 9 0 13 21 9 0 13 21 9 0 13 9 9 0 0 
0 0 5 6 9 9 10 6 22 23 10 6 22 23 10 6 22 23 10 6 22 23 10 6 22 23 10 6 9 9 0 0 
0 0 26 27 9 9 9 9 28 13 9 9 28 13 9 9 28 13 9 9 28 13 9 9 28 13 9 9 24 25 0 0 
0 0 34 35 9 9 9 9 36 13 9 9 36 13 9 9 36 13 9 9 36 13 9 9 36 13 9 9 32 33 0 0 
0 0 0 0 0 0 0 0 0 0 0 0 0 0 0 0 0 0 0 0 0 0 0 0 0 0 0 0 0 0 0 0 
0 0 0 0 0 0 0 0 0 0 0 0 0 0 0 0 0 0 0 0 0 0 0 0 0 0 0 0 0 0 0 0 
