2 3 2 3 2 3 2 3 2 3 2 3 2 3 2 3 2 3 2 3 2 3 2 3 2 3 2 3 2 3 2 3 
3 12 12 2 3 12 12 2 3 12 12 2 3 12 12 2 3 12 12 2 3 12 12 2 3 12 12 2 3 12 12 2 
2 3 4 5 5 5 5 5 5 5 5 5 5 5 5 5 5 5 5 5 5 5 5 5 5 5 5 5 5 5 2 3 
3 12 13 9 9 9 9 9 9 9 9 9 9 9 9 9 9 9 9 9 9 9 9 9 9 9 9 9 9 9 12 2 
2 3 2 3 2 3 18 9 9 9 9 9 9 9 9 9 9 9 9 9 9 9 2 3 2 3 18 9 9 9 2 3 
3 12 12 2 3 12 13 9 9 9 9 9 9 9 9 9 9 9 9 9 9 9 12 2 3 12 13 9 9 9 12 2 
2 3 26 27 4 5 6 9 9 9 9 9 9 9 9 9 9 9 9 9 9 9 10 5 5 5 6 9 9 9 2 3 
3 12 34 35 13 9 9 9 9 9 9 9 9 9 9 9 9 9 9 9 9 9 9 9 9 9 9 9 9 9 12 2 
2 3 2 3 2 3 18 9 9 9 9 9 9 9 9 9 9 9 9 9 9 9 9 9 9 9 9 9 9 9 2 3 
3 12 12 2 3 12 13 9 9 9 9 9 9 9 9 9 9 9 9 9 9 9 9 9 9 9 9 9 9 9 12 2 
2 3 4 5 5 5 6 7 8 9 9 9 9 9 9 9 9 9 9 9 9 9 9 9 9 9 9 9 9 9 2 3 
3 12 13 9 9 9 9 14 15 9 9 9 9 9 9 9 9 9 9 9 9 9 9 9 9 9 9 9 9 9 12 2 
2 3 13 9 9 9 12 17 17 12 18 9 9 9 9 9 9 9 9 9 9 9 9 9 9 9 9 9 9 9 2 3 
3 12 13 9 9 9 12 2 3 12 13 9 9 9 9 9 9 9 9 9 9 9 9 9 9 9 9 9 9 9 12 2 
2 3 13 7 8 9 10 5 5 5 6 7 8 9 9 9 9 9 9 9 9 9 9 9 9 9 9 9 9 9 2 3 
3 12 13 14 15 9 9 9 9 9 9 14 15 9 9 9 9 9 9 9 9 9 9 9 9 9 9 9 9 9 12 2 
2 3 2 3 2 3 18 9 9 9 12 17 17 12 18 9 9 9 9 9 9 9 9 9 9 9 9 9 9 9 2 3 
3 12 12 2 3 12 13 9 9 9 12 2 3 12 13 9 9 9 9 9 9 9 9 9 9 9 9 9 9 9 12 2 
2 3 4 5 5 5 6 7 8 9 10 5 5 5 6 7 8 9 9 9 9 9 9 9 9 9 9 9 9 9 2 3 
3 12 13 9 9 9 9 14 15 9 9 9 9 9 9 14 15 9 9 9 9 9 9 9 9 9 9 9 9 9 12 2 
2 3 13 9 9 9 12 17 17 12 18 9 9 9 2 3 2 3 18 9 9 9 9 9 9 9 9 9 9 9 2 3 
3 12 13 9 9 9 12 2 3 12 13 9 9 9 12 2 3 12 13 9 9 9 9 9 9 9 9 9 9 9 12 2 
2 3 13 7 8 9 10 5 5 5 6 7 8 9 10 5 5 5 6 7 8 9 9 9 9 9 9 9 9 9 2 3 
3 12 13 14 15 9 9 9 9 9 9 14 15 9 9 9 9 9 9 14 15 9 9 9 9 9 9 9 9 9 12 2 
2 3 2 3 2 3 18 9 9 9 2 3 2 3 18 9 9 9 12 17 17 12 18 9 9 9 9 9 9 9 2 3 
3 12 12 2 3 12 13 9 9 9 12 2 3 12 13 9 9 9 12 2 3 12 13 9 9 9 9 9 9 9 12 2 
2 3 4 5 5 5 6 7 8 9 10 5 5 5 6 7 8 9 10 5 5 5 6 7 8 9 9 9 9 9 2 3 
3 12 13 9 9 9 9 14 15 9 9 9 9 9 9 14 15 9 9 9 9 9 9 14 15 9 9 9 9 9 12 2 
2 3 13 9 9 9 2 3 2 3 18 9 9 9 2 3 2 3 2 3 2 3 2 3 2 3 18 9 9 9 2 3 
3 12 13 9 9 9 12 2 3 12 13 9 9 9 12 2 3 12 12 2 3 12 12 2 3 12 13 9 9 9 12 2 
2 3 13 7 8 9 10 5 5 5 6 7 8 9 10 5 5 5 5 5 5 5 5 5 5 5 6 9 9 9 2 3 
3 12 13 14 15 9 9 9 9 9 9 14 15 9 9 9 9 9 9 9 9 9 9 9 9 9 9 9 9 9 12 2 
2 3 2 3 2 3 18 9 9 9 12 17 17 12 2 3 2 3 2 3 2 3 18 9 9 9 9 9 9 9 2 3 
3 12 12 2 3 12 13 9 9 9 12 2 3 12 12 2 3 12 12 2 3 12 13 9 9 9 9 9 9 9 12 2 
2 3 4 5 5 5 6 7 8 9 10 5 5 5 5 5 5 5 5 5 5 5 6 7 8 9 9 9 9 9 2 3 
3 12 13 9 9 9 9 14 15 9 9 9 9 9 9 9 9 9 9 9 9 9 9 14 15 9 9 9 9 9 12 2 
2 3 2 3 2 3 2 3 2 3 2 3 2 3 2 3 2 3 18 9 9 9 2 3 2 3 18 9 9 9 2 3 
3 12 12 2 3 12 12 2 3 12 12 2 3 12 3 2 3 12 13 9 9 9 12 2 3 12 13 9 9 9 12 2 
2 3 4 5 5 5 5 5 5 5 5 5 5 5 5 5 5 5 6 7 8 9 10 5 5 5 6 9 9 9 2 3 
3 12 13 9 9 9 9 9 9 9 9 9 9 9 9 9 9 9 9 14 15 9 9 9 9 9 9 9 9 9 12 2 
2 3 13 9 9 9 2 3 2 3 2 3 2 3 18 9 9 9 12 17 17 12 2 3 2 3 18 9 9 9 2 3 
3 12 13 9 9 9 12 2 3 12 12 2 3 12 13 9 9 9 12 2 3 12 12 2 3 12 13 9 9 9 12 2 
2 3 13 7 8 9 10 5 5 5 5 5 5 5 6 7 8 9 10 5 5 5 5 5 5 5 6 9 9 9 2 3 
3 12 13 14 15 9 9 9 9 9 9 9 9 9 9 14 15 9 9 9 9 9 9 9 9 9 9 9 9 9 12 2 
2 3 12 17 17 12 2 3 2 3 18 9 9 9 12 17 17 12 2 3 2 3 18 9 9 9 9 9 9 9 2 3 
3 12 12 2 3 12 12 2 3 12 13 9 9 9 12 2 3 12 12 2 3 12 13 9 9 9 9 9 9 9 12 2 
2 3 4 5 5 5 5 5 5 5 6 7 8 9 10 5 5 5 5 5 5 5 6 7 8 9 9 9 9 9 2 3 
3 12 13 9 9 9 9 9 9 9 9 14 15 9 9 9 9 9 9 9 9 9 9 14 15 9 9 9 9 9 12 2 
2 3 13 9 9 9 2 3 2 3 12 17 17 12 2 3 2 3 18 9 9 9 2 3 2 3 18 9 9 9 2 3 
3 12 13 9 9 9 12 2 3 12 12 2 3 12 12 2 3 12 13 9 9 9 12 2 3 12 13 9 9 9 12 2 
2 3 13 7 8 9 10 5 5 5 5 5 5 5 5 5 5 5 6 7 8 9 10 5 5 5 6 7 8 9 2 3 
3 12 13 14 15 9 9 9 9 9 9 9 9 9 9 9 9 9 9 14 15 9 9 9 9 9 9 14 15 9 12 2 
2 3 12 17 17 12 18 9 9 9 2 3 2 3 18 9 9 9 2 3 2 3 2 3 2 3 2 3 2 3 2 3 
3 12 12 2 3 12 13 9 9 9 12 2 3 12 13 9 9 9 12 2 3 12 12 2 3 12 12 2 3 12 12 2 
2 3 26 27 4 5 6 7 8 9 10 5 5 5 6 7 8 9 10 5 5 5 5 5 5 5 5 5 24 25 2 3 
3 12 34 35 13 9 9 14 15 9 9 9 9 9 9 14 15 9 9 9 9 9 9 9 9 9 9 9 32 33 12 2 
2 3 2 3 2 3 2 3 2 3 18 9 9 9 2 3 2 3 2 3 2 3 18 9 9 9 2 3 2 3 2 3 
3 12 12 2 3 12 12 2 3 12 13 9 9 9 12 2 3 12 12 2 3 12 13 9 9 9 12 2 3 12 12 2 
2 3 4 5 5 5 5 5 5 5 6 7 8 9 10 5 5 5 5 5 5 5 6 7 8 9 10 5 5 5 2 3 
3 12 13 9 9 9 9 9 9 9 9 14 15 9 9 9 9 9 9 9 9 9 9 14 15 9 9 9 9 9 12 2 
2 3 2 3 2 3 2 3 2 3 2 3 2 3 2 3 2 3 2 3 2 3 2 3 2 3 2 3 2 3 2 3 
3 12 12 2 3 12 12 2 3 12 12 2 3 12 12 2 3 12 12 2 3 12 12 2 3 12 12 2 3 12 12 2 