16 16 16 16 16 16 16 16 16 16 16 16 16 16 16 16 16 16 16 16 16 16 16 16 16 16 16 16 16 16 16 16 
40 40 40 40 40 40 40 40 40 40 40 40 40 40 40 40 40 40 40 40 40 40 40 40 40 40 40 40 40 40 40 40 
1 1 1 1 1 1 1 1 1 1 1 1 1 1 1 1 1 1 1 1 1 1 1 1 1 1 1 1 1 1 1 1 
1 1 1 1 1 1 1 1 1 1 1 1 1 1 1 1 1 1 1 1 1 1 1 1 1 1 1 1 1 1 1 1 
0 0 0 0 0 0 0 0 0 0 0 0 0 0 0 0 0 0 0 0 0 0 0 0 0 0 0 0 0 0 0 0 
0 0 0 0 0 0 0 0 0 0 0 0 0 0 0 0 0 0 0 0 0 0 0 0 0 0 0 0 0 0 0 0 
42 43 42 43 42 43 42 43 42 43 42 43 42 43 42 43 42 43 42 43 42 43 42 43 42 43 42 43 42 43 42 43 
43 50 50 42 43 50 50 42 43 50 50 42 43 50 50 42 43 50 50 42 43 50 50 42 43 50 50 42 43 50 50 42 
42 43 56 57 57 57 57 58 59 60 61 58 59 60 61 58 59 60 61 58 59 60 61 58 56 57 57 57 57 57 42 43 
43 50 63 64 64 64 64 65 66 67 68 65 66 67 68 65 66 67 68 65 66 67 68 65 63 64 64 64 64 64 50 42 
42 43 63 64 64 64 64 65 63 64 64 65 63 64 64 65 63 64 64 65 63 64 64 65 63 64 42 43 42 43 42 43 
43 50 63 64 64 64 64 65 63 64 64 65 63 64 64 65 63 64 64 65 63 64 64 65 63 64 50 42 43 50 50 42 
42 43 63 64 29 30 64 65 63 64 64 65 63 64 64 65 63 64 64 65 63 64 64 65 63 64 57 57 24 25 42 43 
43 50 63 80 37 38 64 65 63 64 64 65 63 64 64 65 63 64 64 65 63 64 64 65 63 64 64 64 32 33 50 42 
42 43 42 80 42 43 81 65 63 64 64 65 63 64 42 43 42 43 81 65 63 64 64 65 63 64 42 43 42 43 42 43 
43 50 50 80 43 50 63 65 63 64 64 65 63 64 50 42 43 50 63 65 63 64 64 65 63 64 50 42 43 50 50 42 
42 43 56 80 56 57 84 65 63 64 64 65 63 64 57 58 56 57 84 65 63 85 64 65 63 85 57 58 59 60 42 43 
43 50 63 80 63 64 64 65 63 64 64 65 63 64 64 65 63 64 64 86 63 87 64 86 63 87 64 65 66 67 50 42 
42 43 63 80 63 64 64 65 63 64 64 65 63 64 64 65 63 64 42 43 42 43 42 43 42 43 81 65 63 64 42 43 
43 50 63 80 63 64 64 65 63 64 64 65 63 64 64 65 63 64 50 42 43 50 50 42 43 50 63 65 63 64 50 42 
42 43 63 80 63 64 64 65 63 64 64 65 63 64 64 65 63 85 57 58 59 60 61 58 56 57 84 65 63 64 42 43 
43 50 63 80 63 64 64 65 63 64 64 65 63 64 64 86 63 87 64 65 66 67 68 65 63 64 64 65 63 64 50 42 
42 43 63 80 63 64 64 65 63 64 64 65 63 64 42 43 42 43 81 65 63 64 64 65 63 64 64 65 63 64 42 43 
43 50 63 80 63 64 64 65 63 64 64 65 63 64 50 42 43 50 63 65 63 64 64 65 63 64 64 65 63 64 50 42 
42 43 63 80 63 85 64 65 63 85 64 65 63 85 57 57 57 57 84 65 63 85 64 65 63 64 64 65 63 85 42 43 
43 50 63 80 63 87 64 86 63 87 64 86 63 87 64 64 64 64 64 86 63 87 64 65 63 64 64 86 63 87 50 42 
42 43 42 43 42 43 17 17 17 17 42 43 42 43 42 43 42 43 42 43 42 43 81 65 63 64 42 43 42 43 42 43 
43 50 50 42 43 50 50 42 43 50 50 42 43 50 50 42 43 50 50 42 43 50 63 65 63 64 50 42 43 50 50 42 
42 43 56 58 59 60 61 58 59 60 61 58 59 60 61 58 59 60 61 58 56 57 84 65 63 85 57 58 59 60 42 43 
43 50 63 65 66 67 68 65 66 67 68 65 66 67 68 65 66 67 68 65 63 64 64 86 63 87 64 65 66 67 50 42 
42 43 63 65 63 64 64 65 63 64 64 65 63 64 64 65 63 64 64 65 63 64 42 43 42 43 81 65 63 64 42 43 
43 50 63 65 63 64 64 65 63 64 64 65 63 64 64 65 63 64 64 65 63 64 50 42 43 50 63 65 63 64 50 42 
42 43 63 65 63 85 64 65 63 64 64 65 63 85 64 65 63 85 64 65 63 85 57 57 57 57 84 65 63 85 42 43 
43 50 63 86 63 87 64 65 63 64 64 86 63 87 64 86 63 87 64 86 63 87 64 64 64 64 64 86 63 87 50 42 
42 43 42 43 42 43 81 65 63 64 42 43 42 43 17 17 17 17 42 43 42 43 42 43 42 43 42 43 42 43 42 43 
43 50 50 42 43 50 63 65 63 64 50 42 43 50 50 42 43 50 50 42 43 50 50 42 43 50 50 42 43 50 50 42 
42 43 56 58 56 57 84 65 63 85 57 58 59 60 61 58 59 60 61 58 59 60 61 58 59 60 61 58 59 60 42 43 
43 50 63 65 63 64 64 86 63 87 64 65 66 67 68 65 66 67 68 65 66 67 68 65 66 67 68 65 66 67 50 42 
42 43 63 65 63 64 42 43 42 43 81 65 63 64 64 65 63 64 64 65 63 64 64 65 63 64 64 65 63 64 42 43 
43 50 63 65 63 64 50 42 43 50 63 65 63 64 64 65 63 64 64 65 63 64 64 65 63 64 64 65 63 64 50 42 
42 43 63 65 63 85 57 57 57 57 84 65 63 85 64 65 63 85 64 65 63 64 64 65 63 64 64 65 63 85 42 43 
43 50 63 86 63 87 64 64 64 64 64 86 63 87 64 86 63 87 64 65 63 64 64 65 63 64 64 86 63 87 50 42 
42 43 42 43 42 43 42 43 42 43 42 43 42 43 42 43 42 43 81 65 63 64 64 65 63 64 42 43 42 43 42 43 
43 50 50 42 43 50 50 42 43 50 50 42 43 50 50 42 43 50 63 65 63 64 64 65 63 64 50 42 43 50 50 42 
42 43 56 58 59 60 61 58 59 60 61 58 59 60 61 58 56 57 84 65 63 85 64 65 63 85 57 57 24 25 42 43 
43 50 63 65 66 67 68 65 66 67 68 65 66 67 68 65 63 64 64 86 63 87 64 86 63 87 64 64 32 33 50 42 
42 43 63 65 63 64 64 65 63 64 64 65 63 64 64 65 63 64 42 43 42 43 42 43 42 43 42 43 42 43 42 43 
43 50 63 65 63 64 64 65 63 64 64 65 63 64 64 65 63 64 50 42 43 50 50 42 43 50 50 42 43 50 50 42 
42 43 63 65 63 64 64 65 63 85 64 65 63 85 64 65 63 85 57 58 59 60 61 58 59 60 61 58 59 60 42 43 
43 50 63 65 63 64 64 86 63 87 64 86 63 87 64 86 63 87 64 65 66 67 68 65 66 67 68 65 66 67 50 42 
42 43 63 65 63 64 42 43 42 43 17 17 17 17 42 43 42 43 81 65 63 64 64 65 63 64 64 65 63 64 42 43 
43 50 63 65 63 64 50 42 43 50 50 42 43 50 50 42 43 50 63 65 63 64 64 65 63 64 64 65 63 64 50 42 
42 43 63 65 63 85 57 58 59 60 61 58 59 60 61 58 56 57 84 65 63 64 64 65 63 64 64 65 63 64 42 43 
43 50 63 86 63 87 64 65 66 67 68 65 66 67 68 65 63 64 64 65 63 64 64 65 63 64 64 65 63 64 50 42 
42 43 42 43 42 43 81 65 63 64 64 65 63 64 64 65 63 64 64 65 63 64 64 65 63 64 64 65 63 64 42 43 
43 50 50 42 43 50 63 65 63 64 64 65 63 64 64 65 63 64 64 65 63 64 64 65 63 64 64 65 63 64 50 42 
42 43 56 57 57 57 84 65 63 85 64 65 63 85 64 65 63 85 64 65 63 85 64 65 63 85 64 65 63 64 42 43 
43 50 63 64 64 64 64 86 63 87 64 86 63 87 64 86 63 87 64 86 63 87 64 86 63 87 64 65 63 64 50 42 
42 43 42 43 42 43 42 43 42 43 42 43 42 43 42 43 42 43 17 17 17 17 42 43 42 43 81 65 63 64 42 43 
43 50 50 42 43 50 50 42 43 50 50 42 43 50 50 42 43 50 50 42 43 50 50 42 43 50 63 65 63 64 50 42 
42 43 26 27 56 57 57 58 59 60 119 119 59 60 61 58 59 60 61 58 59 60 61 58 56 57 84 65 63 85 42 43 
43 50 34 35 63 64 64 65 66 67 119 119 66 67 68 65 66 67 68 65 66 67 68 65 63 64 64 86 63 87 50 42 
42 43 42 43 42 43 81 65 63 64 119 119 63 64 64 65 63 64 64 65 63 64 64 65 63 64 42 43 42 43 42 43 
43 50 50 42 43 50 63 65 63 64 119 119 63 64 64 65 63 64 64 65 63 64 64 65 63 64 50 42 43 50 50 42 
42 43 56 58 56 57 64 65 63 85 119 119 63 85 64 65 63 85 64 65 63 64 64 65 63 85 57 57 57 57 42 43 
43 50 63 65 63 64 64 86 63 87 39 39 63 87 64 86 63 87 64 65 63 64 64 86 63 87 64 64 64 64 50 42 
42 43 63 65 63 64 42 43 42 43 42 43 42 43 42 43 42 43 81 65 63 64 42 43 42 43 42 43 42 43 42 43 
43 50 63 65 63 64 50 42 43 50 50 42 43 50 50 42 43 50 63 65 63 64 50 42 43 50 50 42 43 50 50 42 
42 43 63 65 63 85 57 58 59 60 119 119 59 60 61 58 56 57 84 65 63 85 57 58 59 60 61 58 59 60 42 43 
43 50 63 86 63 87 64 65 66 67 119 119 66 67 68 65 63 64 64 86 63 87 64 65 66 67 68 65 66 67 50 42 
42 43 42 43 42 43 42 43 42 43 119 119 63 64 64 65 63 64 42 43 42 43 81 65 63 64 64 65 63 64 42 43 
43 50 50 42 43 50 50 42 43 50 119 119 63 64 64 65 63 64 50 42 43 50 63 65 63 64 64 65 63 64 50 42 
42 43 56 57 57 57 57 58 59 60 119 119 63 85 64 65 63 85 57 57 57 57 84 65 63 64 64 65 63 85 42 43 
43 50 63 64 64 64 64 65 66 67 39 39 63 87 64 86 63 87 64 64 64 64 64 65 63 64 64 86 63 87 50 42 
42 43 42 43 42 43 119 119 63 64 42 43 42 43 42 43 42 43 42 43 42 43 81 65 63 64 42 43 42 43 42 43 
43 50 50 42 43 50 119 119 63 64 50 42 43 50 50 42 43 50 50 42 43 50 63 65 63 64 50 42 43 50 50 42 
42 43 26 27 56 57 119 119 63 85 57 58 59 60 61 58 59 60 61 58 56 57 84 65 63 85 57 57 24 25 42 43 
43 50 34 35 63 64 39 39 63 87 64 65 66 67 68 65 66 67 68 65 63 64 64 86 63 87 64 64 32 33 50 42 
42 43 42 43 42 43 42 43 42 43 81 65 63 64 64 65 63 64 64 65 63 64 42 43 42 43 42 43 42 43 42 43 
43 50 50 42 43 50 50 42 43 50 63 65 63 64 64 65 63 64 64 65 63 64 50 42 43 50 50 42 43 50 50 42 
42 43 56 57 57 57 57 57 57 57 84 65 63 85 64 65 63 85 64 65 63 85 57 57 57 57 57 58 59 60 42 43 
43 50 63 64 64 64 64 64 64 64 64 86 63 87 64 86 63 87 64 86 63 87 64 64 64 64 64 65 66 67 50 42 
42 43 42 43 42 43 42 43 42 43 42 43 42 43 17 17 17 17 42 43 42 43 42 43 42 43 81 65 63 64 42 43 
43 50 50 42 43 50 50 42 43 50 50 42 43 50 50 42 43 50 50 42 43 50 50 42 43 50 63 65 63 64 50 42 
42 43 56 58 59 60 61 58 59 60 61 58 59 60 61 58 59 60 61 58 59 60 61 58 56 57 84 65 63 85 42 43 
43 50 63 65 66 67 68 65 66 67 68 65 66 67 68 65 66 67 68 65 66 67 68 65 63 64 64 86 63 87 50 42 
42 43 63 65 63 64 64 65 63 64 64 65 63 64 64 65 63 64 64 65 63 64 64 65 63 64 42 43 42 43 42 43 
43 50 63 65 63 64 64 65 63 64 64 65 63 64 64 65 63 64 64 65 63 64 64 65 63 64 50 42 43 50 50 42 
42 43 63 65 63 64 64 65 63 85 64 65 63 85 64 65 63 85 64 65 63 85 64 65 63 85 57 58 59 60 42 43 
43 50 63 65 63 64 64 86 63 87 64 86 63 87 64 86 63 87 64 86 63 87 64 86 63 87 64 65 66 67 50 42 
42 43 63 65 63 64 42 43 42 43 17 17 17 17 42 43 42 43 42 43 42 43 42 43 42 43 81 65 63 64 42 43 
43 50 63 65 63 64 50 42 43 50 50 42 43 50 50 42 43 50 50 42 43 50 50 42 43 50 63 65 63 64 50 42 
42 43 63 65 63 85 57 58 59 60 61 58 59 60 61 58 59 60 119 119 59 60 61 58 56 57 84 65 63 85 42 43 
43 50 63 86 63 87 64 65 66 67 68 65 66 67 68 65 66 67 119 119 66 67 68 65 63 64 64 86 63 87 50 42 
42 43 42 43 42 43 81 65 63 64 64 65 63 64 64 65 63 64 119 119 63 64 64 65 63 64 42 43 42 43 42 43 
43 50 50 42 43 50 63 65 63 64 64 65 63 64 64 65 63 64 119 119 63 64 64 65 63 64 50 42 43 50 50 42 
42 43 56 57 57 57 84 65 63 85 64 65 63 85 64 65 63 64 119 119 63 85 64 65 63 85 57 57 57 57 42 43 
43 50 63 64 64 64 64 86 63 87 64 86 63 87 64 65 63 64 119 119 63 87 64 86 63 87 64 64 64 64 50 42 
42 43 42 43 42 43 42 43 42 43 42 43 42 43 81 65 63 64 42 43 42 43 42 43 42 43 42 43 42 43 42 43 
43 50 50 42 43 50 50 42 43 50 50 42 43 50 63 65 63 64 50 42 43 50 50 42 43 50 50 42 43 50 50 42 
42 43 56 58 59 60 61 58 59 60 119 119 56 57 84 65 63 85 57 58 59 60 61 58 59 60 61 58 59 60 42 43 
43 50 63 65 66 67 68 65 66 67 119 119 63 64 64 86 63 87 64 65 66 67 68 65 66 67 68 65 66 67 50 42 
42 43 63 65 63 64 64 65 63 64 119 119 63 64 42 43 42 43 81 65 63 64 64 65 63 64 64 65 63 64 42 43 
43 50 63 65 63 64 64 65 63 64 119 119 63 64 50 42 43 50 63 65 63 64 64 65 63 64 64 65 63 64 50 42 
42 43 63 65 63 85 64 65 63 64 119 119 63 85 57 57 57 57 84 65 63 85 64 65 63 85 64 65 63 64 42 43 
43 50 63 86 63 87 64 65 63 64 39 39 63 87 64 64 64 64 64 86 63 87 64 86 63 87 64 65 63 64 50 42 
42 43 42 43 42 43 81 65 63 64 42 43 42 43 42 43 42 43 42 43 42 43 42 43 42 43 81 65 63 64 42 43 
43 50 50 42 43 50 63 65 63 64 50 42 43 50 50 42 43 50 50 42 43 50 50 42 43 50 63 65 63 64 50 42 
42 43 26 27 56 57 84 65 63 85 57 58 59 60 61 58 59 60 61 58 59 60 61 58 56 57 84 65 63 85 42 43 
43 50 34 35 63 64 64 86 63 87 64 65 66 67 68 65 66 67 68 65 66 67 68 65 63 64 64 86 63 87 50 42 
42 43 42 43 42 43 42 43 42 43 81 65 63 64 64 65 63 64 64 65 63 64 64 65 63 64 42 43 42 43 42 43 
43 50 50 42 43 50 50 42 43 50 63 65 63 64 64 65 63 64 64 65 63 64 64 65 63 64 50 42 43 50 50 42 
42 43 56 57 57 57 57 57 57 57 84 65 63 85 64 65 63 85 64 65 63 85 64 65 63 85 57 57 57 57 42 43 
43 50 63 64 64 64 64 64 64 64 64 86 63 87 64 86 63 87 64 86 63 87 64 86 63 87 64 64 64 64 50 42 
42 43 42 43 42 43 42 43 42 43 42 43 42 43 42 43 42 43 42 43 42 43 42 43 42 43 42 43 42 43 42 43 
43 50 50 42 43 50 50 42 43 50 50 42 43 50 50 42 43 50 50 42 43 50 50 42 43 50 50 42 43 50 50 42 
